################################################################################
#..........................#...........#########################################
###.####.......#...........#...........#########################################
#......#########...........#....##.....#########################################
#..........................#...........#########################################
#..........##..............#...........#########################################
#...........#..............###..################################################
#############.#.########...............#########################################
#......................#......###......#########################################
#......##..............#......###......#########################################
#......................#...............#########################################
#......................#......###......#########################################
#......##..............#......###......#########################################
#......................#...............#########################################
#......................#......###......#########################################
#......##..............#......###......#########################################
#......................#...............#########################################
#......................#......###......#########################################
#......##..............#......###......#########################################
#......................#...............#########################################
#......................#......###......#########################################
#......##..............#......###......#########################################
#......................#...............#########################################
#......................#......###......#########################################
#......##..............#......###......#########################################
#......................#...............#########################################
#......................#......###......#########################################
#......#x..............#......###......#########################################
#......................#...............#########################################
################################################################################